{
  "textures": [
    0, 0, 0, 0, 0, 0, 0, 0, 0, 0, 0, 0, 0, 0, 0, 0, 0, 0,
    1, 5, 5, 5, 5, 5, 1, 1, 5, 5, 5, 5, 5, 5, 5, 5, 5, 1,
    2, 0, 0, 0, 0, 0, 12, 2, 0, 0, 0, 0, 0, 0, 0, 0, 0, 8,
    2, 0, 0, 0, 0, 0, 0, 10, 0, 0, 0, 0, 0, 0, 0, 0, 0, 12,
    2, 0, 0, 9, 7, 0, 0, 14, 0, 0, 0, 0, 0, 0, 0, 0, 0, 0,
    2, 0, 0, 14, 0, 0, 0, 0, 0, 0, 0, 0, 0, 0, 0, 0, 0, 0,
    2, 0, 0, 0, 0, 0, 0, 0, 0, 0, 13, 7, 0, 0, 0, 13, 1, 1,
    2, 0, 0, 0, 0, 0, 0, 0, 0, 0, 0, 0, 0, 0, 0, 0, 8, 16,
    16, 3, 0, 0, 0, 0, 0, 0, 0, 0, 0, 0, 0, 0, 0, 0, 12, 16,
    16, 2, 0, 0, 0, 0, 0, 0, 0, 0, 0, 0, 0, 0, 0, 0, 0, 8,
    16, 16, 3, 0, 0, 0, 0, 9, 1, 3, 0, 0, 0, 0, 0, 0, 0, 8,
    16, 16, 16, 1, 1, 1, 1, 16, 16, 16, 1, 1, 1, 1, 1, 1, 1, 16
  ],
  "collisions": [
    0, 0, 0, 0, 0, 0, 0, 0, 0, 0, 0, 0, 0, 0, 0, 0, 0, 0,
    1, 5, 5, 5, 5, 5, 1, 1, 5, 5, 5, 5, 5, 5, 5, 5, 5, 1,
    2, 0, 0, 0, 0, 0,12, 2, 0, 0, 0, 0, 0, 0, 0, 0, 0, 8,
    2, 0, 0, 0, 0, 0, 0,10, 0, 0, 0, 0, 0, 0, 0, 0, 0,12,
    2, 0, 0, 9, 7, 0, 0,14, 0, 0, 0, 0, 0, 0, 0, 0, 0, 0,
    2, 0, 0,14, 0, 0, 0, 0, 0, 0, 0, 0, 0, 0, 0, 0, 0, 0,
    2, 0, 0, 0, 0, 0, 0, 0, 0, 0,13, 7, 0, 0, 0,13, 1, 1,
    2, 0, 0, 0, 0, 0, 0, 0, 0, 0, 0, 0, 0, 0, 0, 0, 8, 0,
    0, 3, 0, 0, 0, 0, 0, 0, 0, 0, 0, 0, 0, 0, 0, 0,12, 0,
    0, 2, 0, 0, 0, 0, 0, 0, 0, 0, 0, 0, 0, 0, 0, 0, 0, 8,
    0, 0, 3, 0, 0, 0, 0, 9, 1, 3, 0, 0, 0, 0, 0, 0, 0, 8,
    0, 0, 0, 1, 1, 1, 1, 0, 0, 0, 1, 1, 1, 1, 1, 1, 1, 0
  ],
  "numColumns": 18,
  "player": {
    "location": [2, 7]
  },
  "entities": [
    0, 0, 0, 0, 0, 0, 0, 0, 0, 0, 0, 0, 0, 0, 0, 0, 0, 0,
    0, 0, 0, 0, 0, 0, 0, 0, 0, 0, 0, 0, 0, 0, 0, 0, 0, 0,
    0, 0, 0, 0, 0, 0, 0, 0, 0, 0, 0, 0, 0, 0, 0, 0, 0, 0,
    0, 0,-1, 0, 0, 1, 0, 0, 0, 0, 1, 0, 0, 0, 0, 1, 0, 0,
    0, 0, 0, 0, 0, 0, 0, 0, 0, 0, 0, 0, 0, 0, 0, 0, 0, 0,
    0, 0, 0, 0, 0, 0, 0, 0, 0, 0, 0, 0, 0, 0, 0, 0, 0, 0,
    0, 0, 0, 0, 0, 0, 0, 0, 0, 0, 0, 0, 0, 0, 0, 0, 0, 0,
    0, 0, 0, 0, 0, 0, 0, 0, 0, 0, 0, 0, 0, 0, 0, 0, 0, 0,
    0, 0, 0, 0, 0, 0, 0, 0, 0, 0, 0, 0, 0, 0, 0, 0, 0, 0,
    0, 0, 0, 0, 1, 0, 0, 0, 0, 0, 0, 0, 0, 0, 1, 0, 0, 0,
    0, 0, 0, 0, 0, 0, 0, 0, 0, 0, 0, 0, 0, 0, 0, 0, 0, 0,
    0, 0, 0, 0, 0, 0, 0, 0, 0, 0, 0, 0, 0, 0, 0, 0, 0, 0
  ],
  "doors": [
    {
      "to": 1,
      "relativePos": [-18, 0],
      "locations": [
        [18, 4],
        [18, 5]
      ]
    }
  ],
  "dialogue": [
    {
      "duration": 300,
      "text": [
        "Duration is measured in ticks. Dialogue must be in order.",
        "You get 4 lines of text. You don't have to use all of it.",
        "",
        "Unfortunately, there's not much we can do about the font."
      ]
    }
  ]
}