{
    "textures": [
      0, 0, 0, 0, 0, 0, 0, 0, 0, 0, 0, 0, 0, 0, 0, 0, 0, 15,
      1, 0, 0, 0, 5, 5, 1, 1, 5, 5, 5, 5, 0, 0, 0, 0, 0, 0,
      2, 0, 0, 0, 0, 0, 8, 2, 0, 0, 0, 0, 0, 0, 0, 0, 0, 8,
      2, 0, 0, 0, 0, 0, 0, 2, 0, 0, 0, 0, 0, 0, 0, 0, 0, 8,
      2, 0, 0, 0, 0, 0, 0,14, 0, 0, 0, 0, 0, 0, 0, 0, 0, 8,
      2, 0, 0, 0, 0, 0, 0, 15, 0, 0, 0, 0, 0, 0, 0, 0, 0, 8,
      2, 0, 0, 0, 0, 0, 0, 15, 0, 0,13, 7, 0, 0, 0,13, 1, 8,
      2, 0, 0, 0, 0, 0, 0, 15, 0, 0, 0, 0, 0, 0, 0, 0, 0, 8,
     16, 3, 0, 0, 0, 0, 12, 0, 0, 0, 0, 0, 0, 0, 0, 0,8,8,
     16, 2, 0, 0, 0, 0, 0, 0, 0, 12, 0, 0, 0, 0, 0, 0, 0,8,
     16,16, 3, 0, 0, 0, 0, 9, 1, 0, 0, 0, 0, 0, 0, 0, 0, 8,
     16,16,16, 1, 1, 1, 1,16,16,16, 1, 1, 1, 1, 1, 1, 1,16
    ],
    "collisions": [
      15, 15, 15, 15, 15, 15, 15, 15, 15, 15, 15, 15, 15, 15, 15, 15, 15, 15,
      1, 0, 0, 0, 5, 5, 1, 1, 5, 5, 5, 7, 0, 0, 0, 0, 0, 0,
      2, 0, 0, 0, 0, 0, 15, 15, 0, 0, 0, 0, 0, 0, 0, 0, 0, 8,
      2, 0, 0, 0, 0, 0, 0, 15, 0, 0, 0, 0, 0, 0, 0, 0, 0,12,
      2, 0, 0, 0, 0, 0, 0,15, 0, 0, 0, 0, 0, 0, 0, 0, 0, 8,
      2, 0, 0, 0, 0, 0, 0, 15, 0, 0, 0, 0, 0, 0, 0, 0, 0, 8,
      2, 0, 0, 0, 0, 0, 0, 15, 0, 0,13, 7, 0, 0, 0,13, 1, 1,
      2, 0, 0, 0, 0, 0, 0, 15, 0, 0, 0, 0, 0, 0, 0, 0, 0, 0,
      0, 3, 0, 0, 0, 0, 12, 0, 0, 0, 0, 0, 0, 0, 0, 0, 8, 0,
      0, 2, 0, 0, 0, 0, 0, 0, 0, 15, 0, 0, 0, 0, 0, 0, 0, 8,
      0, 0, 3, 0, 0, 0, 0, 15, 15, 0, 0, 0, 0, 0, 0, 0, 0, 8,
      0, 0, 0, 1, 1, 1, 1, 0, 0, 0, 1, 1, 1, 1, 1, 1, 1, 0
    ],
    "numColumns": 18,
    "player": {
      "location": [2, 7]
    },
    "entities": [
      1, 0, 0, 0, 0, 0, 0, 0, 0, 0, 0, 0, 0, 0, 0, 0, 0, 0,
      0, 0, 0, 0, 0, 0, 0, 1, 0, 1, 0, 0, 0, 0, 0, 1, 0, 0,
      0, 0, 0, 0, 0, 0, 0, 0, 0, 0, 0, 1, 0, 0, 0, 0, 0, 0,
      0, 0,-1, 0, 0, 0, 0, 0, 0, 0, 1, 0, 0, 0, 0, 1, 0, 0,
      0, 0, 0, 0, 0, 0, 0, 0, 0, 0, 0, 0, 1, 0, 0, 0, 0, 0,
      0, 1, 0, 0, 1, 0, 0, 0, 0, 0, 1, 0, 0, 0, 0, 0, 0, 0,
      0, 0, 0, 0, 0, 0, 0, 0, 0, 0, 0, 0, 0, 0, 0, 0, 0, 0,
      0, 0, 0, 0, 0, 0, 0, 0, 0, 0, 0, 0, 1, 0, 0, 0, 0, 0,
      0, 0, 0, 1, 0, 0, 0, 0, 0, 0, 0, 0, 0, 0, 0, 0, 0, 0,
      0, 0, 0, 0, 0, 0, 0, 0, 0, 0, 0, 0, 0, 0, 1, 0, 0, 0,
      0, 0, 0, 0, 0, 0, 0, 0, 1, 1, 0, 0, 0, 0, 0, 0, 0, 0,
      0, 0, 0, 0, 0, 0, 0, 0, 0, 0, 0, 0, 0, 0, 0, 0, 0, 0
    ],
    "doors": [
      {
        "to": 2,
        "relativePos": [-16, 0],
        "locations": [
          [18, 1]
        ]
      }, 

      {
          "to": 4,
          "relativePos": [-8, 1],
          "locations":[
              [1, 1],
              [1, 2]
          ]
      }
    ],
    "dialogue": [
      {
        "duration": 50,
        "text": [
          "You have undergone MUTATION",
          "You are now able to: WALL STICK",
          "",
          ""
        ]
      }
    ]
  }