{
    "textures": [
      16, 4, 4, 4,16,16,16,16,16,16,16,16, 4, 4, 4, 4, 4, 4,
       2, 0, 0, 0,12, 4,16,16, 4, 4, 4, 6, 0, 0, 0, 0, 0, 0,
       2, 0, 0, 0, 0, 0,12, 2, 0, 0, 0, 0, 0, 0, 0, 0, 0, 9,
       2, 0, 0, 0, 0, 0, 0,10, 0, 0, 0, 0, 0, 0, 0, 0, 0, 8,
       2, 0, 0, 0, 0, 0, 0,10, 0, 0, 0, 0, 0, 0, 0, 0, 0, 8,
       2, 0, 0, 0, 0, 0, 0,10, 0, 0, 0, 0, 0, 0, 0, 0, 0,10,
       2, 0, 0, 0, 0, 0, 0,10, 0, 0,13, 7, 0, 0, 0,13, 5,16,
       2, 0, 0, 0, 0, 0, 0,14, 0, 0, 0, 0, 0, 0, 0, 0, 0, 8,
      16, 3, 0, 0, 0, 0,15, 0, 0, 0, 0, 0, 0, 0, 0, 0,13,16,
      16, 2, 0, 0, 0, 0, 0, 0, 0,15, 0, 0, 0, 0, 0, 0, 0, 8,
      16,16, 3, 0, 0, 0, 0, 9, 3, 0, 0, 0, 0, 0, 0, 0, 0, 8,
      16,16,16, 1, 1, 1, 1,16,16, 1, 1, 1, 1, 1, 1, 1, 1,16
    ],
    "collisions": [
      16, 4, 4, 4,16,16,16,16,16,16,16,16, 4, 4, 4, 4, 4, 4,
       2, 0, 0, 0,12, 4,16,16, 4, 4, 4, 6, 0, 0, 0, 0, 0, 0,
       2, 0, 0, 0, 0, 0,12, 2, 0, 0, 0, 0, 0, 0, 0, 0, 0, 9,
       2, 0, 0, 0, 0, 0, 0,10, 0, 0, 0, 0, 0, 0, 0, 0, 0, 8,
       2, 0, 0, 0, 0, 0, 0,10, 0, 0, 0, 0, 0, 0, 0, 0, 0, 8,
       2, 0, 0, 0, 0, 0, 0,10, 0, 0, 0, 0, 0, 0, 0, 0, 0,10,
       2, 0, 0, 0, 0, 0, 0,10, 0, 0,13, 7, 0, 0, 0,13, 5,16,
       2, 0, 0, 0, 0, 0, 0,14, 0, 0, 0, 0, 0, 0, 0, 0, 0, 8,
      16, 3, 0, 0, 0, 0,15, 0, 0, 0, 0, 0, 0, 0, 0, 0,13,16,
      16, 2, 0, 0, 0, 0, 0, 0, 0,15, 0, 0, 0, 0, 0, 0, 0, 8,
      16,16, 3, 0, 0, 0, 0, 9, 3, 0, 0, 0, 0, 0, 0, 0, 0, 8,
      16,16,16, 1, 1, 1, 1,16,16, 1, 1, 1, 1, 1, 1, 1, 1,16
    ],
    "numColumns": 18,
    "player": {
      "location": [2, 7]
    },
    "entities": [
      1, 0, 0, 0, 0, 0, 0, 0, 0, 0, 0, 0, 0, 0, 0, 0, 0, 0,
      0, 0, 0, 0, 0, 0, 0, 1, 0, 1, 0, 0, 0, 0, 0, 1, 0, 0,
      0, 0, 0, 0, 0, 0, 0, 0, 0, 0, 0, 1, 0, 0, 0, 0, 0, 0,
      0, 0,-1, 0, 0, 0, 0, 0, 0, 0, 1, 0, 0, 0, 0, 1, 0, 0,
      0, 0, 0, 0, 0, 0, 0, 0, 0, 0, 0, 0, 1, 0, 0, 0, 0, 0,
      0, 1, 0, 0, 1, 0, 0, 0, 0, 0, 1, 0, 0, 0, 0, 0, 0, 0,
      0, 0, 0, 0, 0, 0, 0, 0, 0, 0, 0, 0, 0, 0, 0, 0, 0, 0,
      0, 0, 0, 0, 0, 0, 0, 0, 0, 0, 0, 0, 1, 0, 0, 0, 0, 0,
      0, 0, 0, 1, 0, 0, 0, 0, 0, 0, 0, 0, 0, 0, 0, 0, 0, 0,
      0, 0, 0, 0, 0, 0, 0, 0, 0, 0, 0, 0, 0, 0, 1, 0, 0, 0,
      0, 0, 0, 0, 0, 0, 0, 0, 1, 1, 0, 0, 0, 0, 0, 0, 0, 0,
      0, 0, 0, 0, 0, 0, 0, 0, 0, 0, 0, 0, 0, 0, 0, 0, 0, 0
    ],
    "doors": [
      {
        "to": 2,
        "relativePos": [-16, 0],
        "locations": [
          [18, 1]
        ]
      }
    ],
    "dialogue": [
      {
        "duration": 120,
        "text": [
          "You Win!",
          "This is all the game we could finish.",
          "Hope you enjoyed!",
          "Music by Eric Matyas - www.soundimage.org"
        ]
      }
    ]
  }